level 01
111111111111011111111111
111111111111100111101001
111111111111101001111100
111111111010110111111111
111111111111010111111111
111111111111110111111111
111111111111111111111111
111011111111111111111111

Level 02
011110100111111111111111
111111111111111111010111
111111111111111111111111
001111001101111111111111
111111111111111111111111
101111111111111110111111
111111111111111111111111
011010111100111111111111

level 03
111011111111111111111111
111111111001111111001111
111111110111111111111111
111111111111111111111111
111111111011100111111101
111111111010111111111110
111100111111111111111111
111111111111111111010101

level 04
001111111111111111111111
111111111111111111100101
111111111010111111111111
111101111111111111100010
111111111111011111111000
111111000111111111111110
111111011110111111111001
111111111111111111111111

level 05
111111111111111111101110
111111111011111111111111
111111111111111111111111
111011111100111111001111
111101111111111110111111
111111111111111111111111
111100111111111111111111
111001010111111111111010

level 06
011111111111111111111110
010111111111000111111111
001111111111111111111111
111111111111111111111111
111111111111111111110000
111111111111010111111011
111101100111111111111111
111001111111111111100101

level 07
111111111111111111111001
010111111111111001111111
111111101111010111111111
111110111111111111011111
111101111111110111111111
111111111111111111111111
111011111111111111111111
111111111111111111111111

level 08
111111111111111100000101
111111111111111111111111
111000111111111111111111
111111111111111111111111
111111111111001111111111
111101110010011111111110
111010111111100111111001
111111111111111111111011

level 09
111111111111111111111111
111110101111111111001111
111111010111111111111111
010111111111111011111111
110111111101111100111111
011100111111111111111111
111111111111111111001111
111111111111111111111111

level 10
111111111100111100111110
111101111111101111111010
111111111111111111111111
111001111111111111111111
111111010111011111110111
111111111111111111111111
111111111111111111111001
011111111111111111111111

level 11
111111111111111101010111
111111111111111111100111
111111111111101111111111
111111111001111111100111
111001111000111111111111
111111111011111111000111
111111111111111111011111
010110111110111111111111

level 12
111011111111111111001111
111111111111100111101111
111111111111110111110111
111101111111111111111111
111111111111111111111010
111111001111111010111111
111111111111111111100111
111111111111011111111111

level 13
010111111111111111111011
111111111111111111111111
111111111001111101111111
111111111111111111100011
111111111111101111111111
111111100111111111010111
001111111111110111110111
111111111111111111111111

level 14
111111001111111111111111
111111111111110111111111
111111111111111011111111
111111111110111111111111
111111111111111111011100
111111100101111111111111
111111111111111111111111
010111111111111010001101

level 15
111101111111111111111111
111111111111111111111111
111111111111001110111111
111111111111111111011111
111111111001010111111111
111111111111111111111010
111111110111111100111100
111111111101111111111011

level 16
101111111111111111010101
111111111111000111111111
111111111111100111111111
111111011111110111111111
000111111111001111111111
001111011111111111111111
111111100110111111010111
111111111111111111111111

level 17
111111111111010111110111
111111100111111010011111
111111110101111111111111
111111111111011111111111
111111111111111001111111
111111111111111111111111
111100111111111111101111
111001111111111111111111

level 18
101111111111111111111100
111111110000100010111111
111111111111111111110111
111111111111111111111111
111001111111111111111111
111111111111011111111111
111011111111101001000111
111111111010111111111111

level 19
111101000111111111111111
111000100111111111111111
111111111100111011111111
111001111010111111111111
111111111111111011110111
111111111111111110010111
111111111111111111111111
101001111111111111111111

level 20
010111111100111111111111
111001111011110111111111
111010111111111111111111
111000111111111111111111
111111111001111111111111
111111111101111111111111
101111111111111111110111
000111011111111111100111

level 21
111111111111111111111111
111010111111111111111000
111111111111111111111100
111111111111101110111111
111111111111111111111111
111111101111111001111111
111111110010001100111011
111111111000011111111111

level 22
111111111111111111111111
111111010000111111111110
111111111111111001111111
111010111101111111100111
111011111111111111111111
111101111111011111111111
111001111111111111111111
111111111110100111111000

level 23
111111111110111111111111
111101111111111111100111
111011111010111111111111
111001111111111101111110
111111111111111111111111
111111011111111111111111
111111111111001010100111
111111111111111111111111

level 24
111111111111000010000111
111111111111011111100111
111111101111111111111111
111111111111111010100111
111111101110111111111111
111111111111111001111111
111110001011111111111111
111111111111111111111111

level 25
111111111111111111111101
111000111000111111111011
111111100111111111111010
111111001111111111111001
111111111011010111111100
111111111111111111111111
111111111111111111111110
111111111111101110111111

level 26
111111111111100101111111
111111111111111111010111
111111111111111001111111
111111111110111111111011
111010111111111111111111
111101111111111001111111
111110111111111111111111
111111111100011111111111

level 27
111000111111111111111111
111101111111111111111111
111000010111100001111111
111111111111111111111111
111111111111110001111111
111111011111010111111111
111111110111011101111111
111111111111111111111100

level 28
111111111111111111111001
111111111111111001111010
111101010111111111111011
111111111111111111101111
111111111000110111111111
111111111111111111111111
111100111111000100110111
111111111011111111111111

level 29
111111111111111111111111
111100111111111111111111
111001111111111111111000
111000111111010111111111
111011111111110111111111
111111111111100111111111
111010101110101111001111
111011111111111111111111

level 30
111111111100111111110111
111001010000111111111111
111111111011111110100111
111111111000111111111111
111111111111111111010111
111111111111001011101111
111101111111111111111111
111111111111111111111111

level 31
101111111111111111111111
111111111011010111010111
111111111111111111111111
111111011110100111111111
111111110111111111111111
111001000111111001111100
111111111111111000111101
111111111111111111111111

level 32
111111111111111111111100
111101011111111111111010
111111111001111111111000
111111111101111111111111
110111000010001011111111
111111111111111111111111
111111111111111111111111
110111111111111111111100

level 33
111111111111111111111111
111001111111111111111111
111010111001111101111111
111100111111111111111111
111111111111100101111111
111111111111111111010111
111110111000011111000111
111111111011111111111110

level 34
111111111111111111111111
111111111111111101110111
111111111111001111111111
111111001111101111111111
111111111111100111111010
111111111111111111100111
010111111111111111110111
011111111011111111111111

level 35
111111111111111111111111
111111111111111001010110
111111100111111100111111
111111111111111111110111
111111111011111111111111
111111111111111101111111
111111001111111011111111
111111111111101010111111

level 36
111111111111100111111111
111101001110000111111111
111111111111001110111111
111111111101111111111111
111111111111111010111100
111111111111111111111111
111011111111111111011111
111111010000111111111111
